WWWWWWWWWWWWWWWWWWWWWWWWWWWWWWWWWWWWWWWWWWWWWWWWWWWWWWWWWWWW
WJ         MWA                                             W
W           W                                    M         W
W           W                                              W
W     W     W                                              W
W     W     W                                           A  W
W     W                                                    W
W     W                                                    W
W     W                             A                      W
WWWWWWWWWWWWWWWWWWWWWWWWWWHWWWWWWWWWWWWWWWWWWWWWWHHHHHHHHHHW
WAHHHHHH                   WM         W       A            W
W H MM H                   W          W                    W
W H    H                   W          W                 M  W
W H MM H                   W          W                    W
W HMMMMH                   W    W     W                    W
W HHHHHH                        W                HHHHHHHHHHW
WWWWWWWWW                       W                          W
W       W                       W                          W
W                          A    W                          W
W          WWWWWWWWWWWWWWWHWWWWWWWWWWWWWWWWWWWWWWWWWWWWWWWWW
W          W                        W          W           W
W          W M                      W  M       W A         W
W          W                        W          W           W
W          W                        W          W           W
W A        WA  W                    W          W          SW
W          WWWW                     W     W    W           W
W                       WWHWW             W                W
W                       WM  W             W                W
W                       W   W             W                W
WWWWWWWWWWWWWWWWWWWWWWWWWWWWWWWWWWWWWWWWWWWWWWWWWWWWWWWWWWWW
