WWWWWWWWWWWWWWWWWWWWWWWWWWWWWWWWWWWWWWWWWWWWWWWWWWWWWWWWWWWW
WJ                         WWWWWWWWWW                      W
W    S                     WA      AH  W                   W
W                          W        H  W                   W
W                          W   M    H  W                   W
W                          W        H  W                   W
W                          HHHHHHHHHH  W                   W
W                                                          W
W                                                          W
W                           WWWWWWWWW        WWWWWWHWW     W
W                                            WA      W     W
W              WWWWWWWW                      H       W     W
W  W  W        H      H                      W   M   W     W
W  W  W       WM    A W                      W       W     W
W  W  WWWWWWWW    WWWWW                      W       W     W
W  W W           W                           W       H     W
W  W         W  W                            W      AW     W
W  W  W        W                             WWHWWWWWW     W
W  WWWWWWWWWWWW             WHWWWWW                        W
W                           W    AH                        W
W                           W M   W                        W
W WWWWWWWWWWWWWW            W     W                        W
W                           W     W                        W
W                           H     H                        W
W                           WHWWWHW                        W
WHHHHHHHHHHHHHHH                                           W
W    W    W    W                                           W
W A  W A  W A  W                                           W
W    W    W    W                                           W
WWWWWWWWWWWWWWWWWWWWWWWWWWWWWWWWWWWWWWWWWWWWWWWWWWWWWWWWWWWW